WE ./textures/01.xpm
EA ./textures/02.xpm
NO ./textures/03.xpm
SO ./textures/04.xpm
C 65, 48,89
F 12, 1,56

11111111111111111111
1W000000000000000001
10000000000000000001
10000000000000000001
10000000000000000001
10000000000000000001
10000000000000000001
10000000000000000001
11111111111111111111
