WE ./textures/01.xpm
EA ./textures/02.xpm
NO ./textures/03.xpm
SO ./textures/04.xpm
C 65, 48,89
F 12, 1,56

1111
111
111
101
1E1
111

1111