WE ./textures/01.xpm
EA ./textures/02.xpm
NO ./textures/03.xpm
SO ./textures/04.xpm

F 27, 41, 90
C 137, 207, 240

1111111
1000001
1000001
1000001
1000001
1000E01
1111111
