WE ./textures/01.xpm
EA ./textures/02.xpm
NO ./textures/03.xpm
SO ./textures/04.xpm

F 27, 41, 90
C 137, 207, 240

        11111111111111111111111111111111111
        10000000001000000001110000000000001
        10110000011000000001110000000000001
        10010000000000000001110000000000001
1111111110110000011111111111110000000000001
1000000000110000011111100000000110111111111
111101111111110111001110101111000010001
111101111111110111011110100001010010001
110000001101010111001110100001000010001
10E000000000000000000000100001000010001
100000000000000011011011111101010000001
110000011101010111111000000000011110001
11010111 1110101 1011100000001111010001
11011111 1111111 1111111111111111111011
1101                               1011
1001                               1011
1101                               1011
10011111111111111111            1111011
11000011000000100011            1000001
11000000000000000001            1001101
11000000111111100011            1100001
11111111111111111011            1111111
                101
                101
                101
                101111111111111111111
                100000001000000000001
                100001000000001000001  11111
                1000010000000010000011110001
                1000010000000010000000000001
                1000010000000010000011110001
                100000000000000000001  11111
                111111110111111111111
                       101
                       101
                       101
                       101
                    111101111
                    100000001
                    101000101
                    100000001
                    111111111
