WE ./textures/01.xpm
EA ./textures/02.xpm
NO ./textures/03.xpm
SO ./textures/04.xpm

F 98,105,109
C 80,130,200


        1111111111111111111111111        11111111111111111111111111
        1000000000110000000000001        1000000001100000100000011
        1011000001110000000000001        100000N0011100000100000011 
        1001000000000000000000001        10000000000000000000000011
1111111110110000010100000100000011111111110110001110100000100000011
1000000000110000011111011111111111  100000000011000001111111111111111
111101111111111111000000100011111011110101101100000001000111
11110111111111011101010000001111101111111110110010100000011
11000000110101011110000010000000000001101010111100000100011
1000000010000000110000010001111000000010000000100000010001111
10000000000000001101010010001100000000000000011010100100011
1100000111010101111111111001110000011101010111110111100111
11111111 101000000000001111111111111 10111110000000110111
1111111111011111111111011           11011111111111111011111111  
1000000000000000000000001          10000000001100000100000011    
1011000001110000000000001         10110000011100000100000011   
10010000000000000000000011111111   1001000000000000000000011111111
111111111011000001010000000000001111111111011100001010000010000001
100000000011000001111101111111111100000000011000001111101111111111
111101111111111111000000100011111001111111110111000000100011
111101111111110111010100000011111011111111101110101000000111
110000001101010111100000100011100000011010101111000001000111
100000001000000011000010000000000000010000000110000010001111
100000000000000011010100100011000000000000000110101001000111
110000011101010111110111100111000001110101011111011110011111
11111111 101111111111111111111111111 10111111111111111111111
         111                         111