WE ./textures/01.xpm
EA ./textures/02.xpm
NO ./textures/03.xpm
SO ./textures/04.xpm
C 65, 48,89
F 100, 0, 0

11111111111111111111
10000001000D00000001
10N000011D1100000001
10000000000000000001
10000000000000000001
10000000000000000001111111111111
10000000000000000000000000000001
10000000000000000001111111111D11
10000000000000000001        1001
10000000000000000001        1111
10000000000000000001
10000000000000000001
10000000000000000001
10000000000000000001
10000000111D00000001
10000000100100000001
10000000100100000001
11111111111111111111
